WWWWWWWWWWWWWWWWWWWWWWWWWWWWWWWWWWWWWWWW
W                                      W
W                                      W
W                                      W
W                                      W
W          L                           W
W                                      W
W                                      W
W                                      W
W                                      W
W                                      W
W                                      W
W                                      W
W                                      W
W                                      W
W     2                                W
W  WWW WWWW                            W
W        W                             W
W       W                              W
W      W    WWW W   WW     WW       K  W
W     W     W   W   W W   W  W         W
W    W      WW  W   W  W  WWWW         D
W   W       W   W   W W  W    W        W
W  WWWWWWWW WWW WWW WW   W    W        W
WWWWWWWWWWWWWWWWWWWWWWWWWWWWWWWWWWWWWWWW