WWWWWWWWWWWWWWWWWWWWWWWWWWWWWWWWWWWWWWWW
W                                      W
W                                      W
W S                  S                 W
W                                      W
W          P              P            W
W                                      W
W                                      W
W     P                                W
W                   P                  W
W                                      W
W                                      W
W            O                O        W
W L                                    W
W                                      W
W           WWWWWWWWWWWWWW             W
W           W                          W
W           W                          W
W           W S                        W
W           W         4                W
W                   WWW            K   W
W                  W F W               W
W                FWWWDWWWF             W
W           P                          W
WWWWWWWWWWWWWWWWWWWWWWWWWWWWWWWWWWWWWWWW