WWWWWWWWWWWWWWWWWWWWWWWWWWWWWWWWWWWWWWWW
W                                      W
W                                      W
W                                      W
W                                      W
W             O                        W
W                                      W
W                                      W
W                                      W
W                                      W
W                                      W
W                                      W
W        P         K                   W
W                                      W
W                                      W
W                                      W
W                                      W
W                                      W
W                                      W
W                                      W
W                                    FWW
W L                                    D
W                                    FWW
W                                      W
WWWWWWWWWWWWWWWWWWWWWWWWWWWWWWWWWWWWWWWW