WWWWWWWWWWWWWWWWWWWWWWWWWWWWWWWWWWWWWWWW
W                                      W
W                                      W
W                    P                 W
W         FW              WF           W
W         W               SW           W
W                                      W
W                                      W
W                                      W
W                                      W
W                                      W
W                 O                    W
W                 K                   6 
W L                                    D
W                                      W
W                                      W
W                                      W
W                                      W
W         WS               W           W
W         FW              WF           W
W                 P                    W
W                                      W
W                                      W
W                                      W
WWWWWWWWWWWWWWWWWWWWWWWWWWWWWWWWWWWWWWWW