WWWWWWWWWWWWWWWWWWWWWWWWWWWWWWWWWWWWWWWW
W                                      W
W                                      W
W                                      W
W                                      W
W      O           O            O      W
W                                      W
W                                      W
W                 B                    W
W                                      W
W                                      W
W                 K                    W
W      O         WWW            O      W
W                WDW                   W
W                 4                    W
W                                      W
W                  L                   W
W                                      W
W                                      W
W                                      W
W      O            O           O      W
W                                      W
W                                      W
W                                      W
WWWWWWWWWWWWWWWWWWWWWWWWWWWWWWWWWWWWWWWW